20 20

100 100

2 2 2 2 2 2 2 2 2 2 2 2 2 2 2 2 2 2 2 2

2 6 6 6 6 6 6 8 1 0 0 0 4 0 5 0 0 0 1 2

2 1 1 2 2 2 2 7 1 1 0 0 4 0 5 0 0 0 1 2

2 1 1 1 1 1 1 7 1 0 0 0 4 0 5 0 0 0 1 2

2 1 1 9 6 6 6 11 1 0 0 0 4 0 5 0 0 0 1 2

2 1 1 7 2 2 2 2 1 0 0 0 4 0 5 0 0 0 1 2

2 1 1 7 1 1 1 1 1 0 0 0 4 0 5 0 0 0 1 2

2 9 6 11 2 2 2 2 1 2 0 0 3 3 3 0 0 0 1 2

2 7 1 1 1 1 1 2 0 2 0 0 4 0 5 0 0 0 1 2

2 7 1 0 0 0 0 2 1 2 0 0 4 0 5 0 0 0 1 2

2 7 1 0 0 0 0 2 0 2 0 0 4 0 5 0 0 0 1 2

2 7 1 1 1 1 1 1 1 1 1 1 4 0 5 0 0 0 1 2

2 7 1 1 1 1 1 1 1 1 1 1 4 0 5 0 0 0 1 2

2 7 1 1 1 1 1 1 1 1 1 1 4 0 5 0 0 0 1 2

2 12 6 6 6 6 6 6 6 6 6 8 4 0 5 0 0 0 1 2

2 7 1 1 1 1 1 1 1 1 1 7 4 0 5 0 0 0 1 2

2 7 1 1 1 1 1 1 1 1 1 7 4 0 5 0 0 0 1 2

2 10 6 6 6 6 6 6 6 6 6 11 4 0 5 0 0 0 1 2

2 1 1 1 1 1 1 1 1 1 1 1 4 0 5 0 0 0 1 2

2 2 2 2 2 2 2 2 2 2 2 2 2 2 2 0 2 2 2 2